12,8,100,5000,8000,3
############
#..C.......#
#.....o....#
#..........#
#.....o....#
#..........#
#....0.1.2.#
############