12,8,100,5000,8000,5
############
#C.........#
#..........#
#..........#
#..........#
##########o#
#43210.....#
############