12,8,10,5000,5000,0
############
#C..o......#
#.......o..#
#.##########
#....o.....#
##########.#
#..........#
############