12,8,10,5000,8000,2
############
#C..o......#
#.......o..#
#.##########
#....o.....#
#########0.#
#0.........#
############