12,8,100,5000,8000,1
############
#C..o......#
#.......o..#
#...########
#..........#
##########.#
#0.........#
############