12,8,10,5000,5000,1
############
#C..o......#
#.......o..#
#.##########
#..........#
#########1.#
#..........#
############