12,8,10,5000,5000,4
############
#C..o......#
#.......o..#
############
#..........#
##0123######
#..........#
############