10,10,10,5000,5000,4
##########
#C..o....#
#.o.o...o#
#.########
#........#
########.#
#........#
#.##0123##
#........#
##########