12,8,100,5000,8000,2
############
#C..o......#
#.......o..#
#...########
#..........#
############
#00........#
############