21,20,10,5000,8000,4
#####################
#C........#.........#
#.##.####.#.####.##.#
#.##.####.#.####.##.#
#....o..............#
#.########.########.#
#.########.########.#
#.########.########.#
#...................#
#.########.########.#
#.########o########.#
#...................#
#.########.########.#
#.########.########.#
#.########.########.#
#...................#
#.##.####.#o####.31.#
#.##.####.#.####.20.#
#.........#.........#
#####################