12,8,100,5000,8000,0
############
#C.........#
#.......o..#
#..........#
#..........#
#######....#
#..........#
############