12,8,10,5000,8000,1
############
#C.........#
#.......o..#
#..........#
#..........#
#######....#
#0.........#
############