11,8,10,5000,5000,2
###########
#...#C#...#
#.#.#.#o#.#
#.#.#.#.#.#
#.#.#.#.#.#
#.#.#.#.#.#
#0#.....#0#
###########