12,8,50,5000,8000,2
############
#C.........#
#.......o..#
#..........#
#..........#
#########0.#
#0.........#
############