12,8,10,5000,8000,13
############
#Co........#
#####3.#####
3..........3
######.#####
#..........#
#0123012301#
############